#################
#               #
# # # # # # # # #
#               #
# # # # # # # # #
#               #
# # # # # # # # #
#               #
# # # # # # # # #
#               #
# # # # # # # # #
#               #
# # # # # # # # #
#               #
# # # # # # # # #
#               #
#################